STRING	STRING	STRING
name	name	name
Derrick	Smith	Derrick
Devin	Jones	Devin
Dick	Williams	Dick
Dominic	Brown	Dominic
Don	Taylor	Don
Donahue	Davies	Donahue
Donald	Wilson	Donald
Douglas	Evans	Douglas
Drew	Thomas	Drew
Duke	Roberts	Duke
Duncan		Duncan
Dunn	Murphy	Dunn
Dwight	O'Kelly	Dwight
Dylan	O'Sullivan	Dylan
Earl	Walsh	Earl
Ed	Smith	Ed
Eden	O'Brien	Eden
Edgar	Byrne	Edgar
Edmund	O'Ryan	Edmund
Edison	O'Connor	Edison
Edward	O'Neill	Edward
Edwiin		Edwiin
Egbert	Jones	Egbert
Eli	Williams	Eli
Elijah	Brown	Elijah
Elliot	Wilson	Elliot
Ellis	Taylor	Ellis
Elmer	Morton	Elmer
Elroy	White	Elroy
Elton	Martin	Elton
Elvis	Anderson	Elvis
Emmanuel	Smith	Emmanuel
Enoch	Johnson	Enoch
Eric	Williams	Eric
Ernest	Brown	Ernest
Eugene	Jones	Eugene
Evan	Miller	Evan
Everley	Davis	Everley
Fabian	Garcia	Fabian
Felix	Rodriguez	Felix
Ferdin	Wilson	Ferdin
Fitch		Fitch
Fitzer	Wilson	Fitzer
Ford	Williams	Ford
Francis	Brown	Francis
Frank	Taylor	Frank
Franklin	Jones	Franklin
Frederic	Singh	Frederic
Gabriel	Wang	Gabriel
Gale	Anderson	Gale
Gary	Li	Gary
Gavin		Gavin
Gene		Gene
Geoffrey		Geoffrey
Geoff		Geoff
George		George
Gerald		Gerald
Gilbert		Gilbert
Giles		Giles
Glenn		Glenn
Goddard		Goddard
Godfery		Godfery
Gordon		Gordon
Greg		Greg
Gregary		Gregary
Griffith		Griffith
Grover		Grover
Gustave		Gustave
Guy		Guy
Hale		Hale
Haley		Haley
Harry		Harry
Hardy		Hardy
Harlan		Harlan
Harley		Harley
Harold		Harold
Harriet		Harriet
Harry		Harry
Harvey		Harvey
Hayden		Hayden
Heather		Heather
Henry		Henry
Herbert		Herbert
Herman		Herman
Hilary		Hilary
Hiram		Hiram
Hobart		Hobart
Hogan		Hogan
Horace		Horace
Howar		Howar
Hubery		Hubery
Hugh		Hugh
Hugo		Hugo
Humphrey		Humphrey
Hunter		Hunter
Hyman		Hyman
Ian		Ian
Ingemar		Ingemar
Ingram		Ingram
Ira		Ira
Isaac		Isaac
Isidore		Isidore
Ivan		Ivan
Ives		Ives
Jack		Jack
Jacob		Jacob
James		James
Jared		Jared
Jason		Jason
Jay		Jay
Jeff		Jeff
Jeffrey		Jeffrey
Jeremy		Jeremy
Jerome		Jerome
Jerry		Jerry
Jesse		Jesse
Jim		Jim
Jo		Jo
John		John
Jonas		Jonas
Jonathan		Jonathan
Joseph		Joseph
Joshua		Joshua
Joyce		Joyce
Julian		Julian
Julius		Julius
Justin		Justin
Keith		Keith
Kelly		Kelly
Ken		Ken
Kennedy		Kennedy
Kenneth		Kenneth
Kent		Kent
Kerr		Kerr
Kerwin		Kerwin
Kevin		Kevin
Kim		Kim
King		King
Kirk		Kirk
Kyle		Kyle
Lambert		Lambert
Lance		Lance
Larry		Larry
Lawrence		Lawrence
Leif		Leif
Len		Len
Lennon		Lennon
Leo		Leo
Leonard		Leonard
Leopold		Leopold
Les		Les
Lester		Lester
Levi		Levi
Lewis		Lewis
Lionel		Lionel
Lou		Lou
Louis		Louis
Lucien		Lucien
Luther		Luther
Lyle		Lyle
Lyndon		Lyndon
Lynn		Lynn
Magee		Magee
Malcolm		Malcolm
Mandel		Mandel
Marcus		Marcus
Marico		Marico
Mark		Mark
Marlon		Marlon
Marsh		Marsh
Marshall		Marshall
Martin		Martin
Marvin		Marvin
Matt		Matt
Matthew		Matthew
Maurice		Maurice
Max		Max
Maxwell		Maxwell
Maxwell		Maxwell
Meredith		Meredith
Merle		Merle
Merlin		Merlin
Michael		Michael
Michell		Michell
Mick		Mick
Mike		Mike
Miles		Miles
Milo		Milo
Monroe		Monroe
Montague		Montague
Moore		Moore
Morgan		Morgan
Mortimer		Mortimer
Morton		Morton
Moses		Moses
Murphy		Murphy
Murray		Murray
Myron		Myron
Nat		Nat
Nathan		Nathan
Nathan		Nathan
Neil		Neil
Nelson		Nelson
Newman		Newman
Nicholas		Nicholas
Nick		Nick
Nigel		Nigel
Noah		Noah
Noel		Noel
Norman		Norman
Norton		Norton
Ogden		Ogden
Oliver		Oliver
Omar		Omar
Orville		Orville
Osborn		Osborn
Oscar		Oscar
Osmond		Osmond
Oswald		Oswald
Otis		Otis
Otto		Otto
Owen		Owen
Page		Page
Parker		Parker
Paddy		Paddy
Patrick		Patrick
Paul		Paul
Philip		Philip
Porter		Porter
Prescott		Prescott
Primo		Primo
Quentin		Quentin
Quennel		Quennel
Quincy		Quincy
Quinn		Quinn
Quintion		Quintion
Rachel		Rachel
Ralap		Ralap
Reuben		Reuben
Rex		Rex
Richard		Richard
Robert		Robert
Robin		Robin
Rock		Rock
Rod		Rod
Roderick		Roderick
Rodney		Rodney
Rudolf		Rudolf
Rupert		Rupert
Ryan		Ryan
Sam		Sam
Sampson		Sampson
Sandy		Sandy
Saxon		Saxon
Scott		Scott
Sean		Sean
Sean		Sean
Sid		Sid
Sidney		Sidney
Simon		Simon
Simon		Simon
Stan		Stan
Stanford		Stanford
Stanley		Stanley
Steven		Steven
Stev		Stev
Steward		Steward
Tab		Tab
Taylor		Taylor
Ted		Ted
Ternence		Ternence
Theobald		Theobald
Theodore		Theodore
Thomas		Thomas
Tiffany		Tiffany
Tim		Tim
Timothy		Timothy
Tobias		Tobias
Toby		Toby
Todd		Todd
Tom		Tom
Tony		Tony
Troy		Troy
Tyler		Tyler
Tyrone		Tyrone
Ulysses		Ulysses
Upton		Upton
Uriah		Uriah
Uriah		Uriah
Uriah		Uriah
Vic		Vic
Victor		Victor
Vincent		Vincent
Virgil		Virgil
Vito		Vito
Vivian		Vivian
Walter		Walter
Ward		Ward
Warner		Warner
Wayne		Wayne
Webb		Webb
Webster		Webster
Wendell		Wendell
Werner		Werner
Wilbur		Wilbur
Will		Will
William		William
Willie		Willie
Winfred		Winfred
Winston		Winston
Wright		Wright
Wythe		Wythe
Yale		Yale
York		York
Yves		Yves